0,0,0,0,0,0,0,0,0,0,0,0,0,0,0,0
0,0,0,0,0,0,0,0,0,0,0,0,0,0,0,0
0,0,0,0,0,0,0,0,0,0,0,0,0,0,0,0
0,0,0,0,0,0,0,0,0,0,0,0,0,0,0,0
0,0,0,0,0,0,0,0,0,0,0,0,0,0,0,0
0,0,0,0,0,0,0,0,0,0,0,0,0,0,0,0
2,1,2,2,3,2,2,3,2,1,2,3,2,1,2,3
13,16,16,16,16,16,16,16,16,16,16,16,16,16,16,14
19,0,0,0,0,0,0,0,0,0,0,0,0,0,0,18
9,3,2,1,3,2,1,2,3,2,2,2,2,1,2,10
