0,0,0,0,0,0,0,0,0,0,0,0,0,0,0,0
0,0,0,0,0,0,0,0,0,0,0,0,0,0,0,0
0,0,0,0,0,0,0,0,0,0,0,0,0,0,0,0
0,0,0,0,0,0,0,0,0,0,0,0,0,0,0,0
0,0,0,0,0,0,0,0,0,0,0,0,11,1,3,2
0,0,0,0,0,0,0,0,0,0,0,0,15,5,5,5
0,0,0,0,0,0,0,0,0,0,0,0,0,0,0,0
0,0,0,0,0,0,0,0,0,11,8,0,0,0,0,0
2,3,2,1,2,2,3,2,2,10,9,2,3,2,1,2
5,5,5,5,5,5,5,5,5,5,5,5,5,5,5,5
