0,0,0,0,0,0,0,0,0,0,0,0,0,0,0,0
0,0,0,0,0,0,0,0,0,0,0,0,0,0,0,0
0,0,0,0,0,0,0,0,0,0,0,0,0,0,0,0
0,0,0,0,0,0,0,0,0,0,0,0,0,0,0,0
0,0,0,0,0,0,0,0,0,0,0,0,11,1,3,2
0,0,0,0,0,0,0,0,0,0,0,0,15,16,16,17
0,0,0,0,0,0,0,0,0,0,0,0,0,0,0,0
0,0,0,0,0,0,0,0,0,11,8,0,0,0,0,0
2,3,2,1,2,2,3,2,2,10,9,2,3,2,1,2
5,7,5,6,5,5,5,4,5,5,6,5,7,5,5,6
