0,0,0,0,0,0,0,0,0,0,0,0,0,0,0,0
0,0,0,0,0,0,0,0,0,0,0,0,0,0,0,0
0,0,0,0,0,0,0,0,11,8,0,0,0,0,0,0
0,0,0,0,0,0,0,0,18,19,0,0,0,0,0,0
0,0,0,0,0,0,0,0,18,9,8,0,0,0,0,0
0,0,0,0,0,0,0,0,15,5,12,0,0,11,3,1
0,0,11,8,0,0,0,0,0,0,0,0,0,18,5,5
0,11,10,9,8,0,0,0,0,0,0,0,11,10,5,5
2,10,5,5,9,1,2,2,1,2,1,2,10,5,5,5
5,5,5,5,5,5,5,5,5,5,5,5,5,5,5,5
