0,0,0,0,0,0,0,0,0,0,0,0,0,0,0,0
0,0,0,0,0,0,0,0,0,0,0,0,0,0,0,0
0,0,0,0,0,0,0,0,11,8,0,0,0,0,0,0
0,0,0,0,0,0,0,0,18,19,0,0,0,0,0,0
0,0,0,0,0,0,0,0,18,9,8,0,0,0,0,0
0,0,0,0,0,0,0,0,15,17,12,0,0,11,3,1
0,0,11,8,0,0,0,0,0,0,0,0,0,18,6,5
0,11,10,9,8,0,0,0,0,0,0,0,11,10,5,5
2,10,6,7,9,3,2,2,1,2,3,2,10,4,5,6
5,6,5,5,5,4,5,5,5,5,7,5,5,6,5,7
