0,0,0,0,0,0,0,0,0,0,0,0,0,0,0,0
0,0,0,0,0,0,0,0,0,0,0,0,0,0,0,0
0,0,0,0,0,0,0,0,0,0,0,0,0,0,0,0
0,0,0,0,0,0,0,0,0,0,0,0,0,0,0,0
0,0,0,0,0,0,0,0,0,0,0,0,0,0,0,0
0,0,0,0,0,0,0,0,0,0,0,0,0,0,0,0
0,0,0,0,0,0,0,0,0,11,2,3,1,2,3,2
0,0,0,0,0,0,0,0,0,18,4,6,5,7,5,6
2,3,2,1,3,2,2,3,1,10,5,5,5,5,5,5
5,4,5,6,5,5,7,5,5,6,5,7,5,6,5,4
