0,0,0,0,0,0,0,0,0,0,0,0,0,0,0,0
0,0,0,0,0,0,0,0,0,0,0,0,0,0,0,0
0,0,0,0,0,0,11,8,0,0,0,0,0,0,0,0
1,3,8,0,11,1,10,19,0,0,0,0,0,0,0,0
13,5,12,0,15,5,5,12,0,0,0,0,0,0,0,0
19,0,0,0,0,0,0,0,0,0,0,0,0,0,0,0
19,0,0,0,0,0,0,0,0,11,8,0,0,0,0,0
9,1,8,0,11,3,1,2,1,10,9,2,1,2,3,1
5,5,19,0,18,5,5,5,5,5,5,5,5,5,5,5
5,5,9,2,10,5,5,5,5,5,5,5,5,5,5,5
