0,0,0,0,0,0,0,0,0,0,0,0,0,0,0,0
0,0,0,0,0,0,0,0,0,0,0,0,0,0,0,0
0,0,0,0,0,0,11,8,0,0,0,0,0,0,0,0
1,3,8,0,11,3,10,19,0,0,0,0,0,0,0,0
13,17,12,0,15,16,17,12,0,0,0,0,0,0,0,0
19,0,0,0,0,0,0,0,0,0,0,0,0,0,0,0
19,0,0,0,0,0,0,0,0,11,8,0,0,0,0,0
9,1,8,0,11,3,1,2,3,10,9,2,1,2,3,2
6,5,19,0,18,5,5,5,6,7,5,5,5,5,4,6
5,7,9,2,10,6,5,4,5,5,5,5,6,5,5,5
