0,0,0,0,0,0,0,0,0,0,0,0,0,0,0,0
0,0,0,0,0,0,0,0,0,0,0,0,0,0,0,0
0,0,0,0,0,0,0,0,0,0,0,0,0,0,0,0
0,0,0,0,0,0,0,0,0,0,0,0,0,0,0,0
0,0,0,0,0,0,0,0,0,0,0,11,8,0,0,0
0,0,0,0,0,0,0,0,0,0,0,15,12,0,0,11
0,0,0,0,0,11,8,0,0,0,0,0,0,0,0,18
0,0,0,0,11,10,19,0,0,0,0,0,0,0,11,10
8,0,11,1,10,5,9,1,3,1,2,3,1,2,10,5
9,1,10,5,5,5,5,5,5,5,5,5,5,5,5,5
