0,0,0,0,0,0,0,0,0,0,0,0,0,0,0,0
0,0,0,0,0,0,0,0,0,0,0,0,0,0,0,0
0,0,0,0,0,0,0,0,0,0,0,0,0,0,0,0
0,0,0,0,0,0,0,0,0,0,0,0,0,0,0,0
0,0,0,0,0,0,0,0,0,0,0,11,8,0,0,0
0,0,0,0,0,0,0,0,0,0,0,15,12,0,0,11
0,0,0,0,0,11,8,0,0,0,0,0,0,0,0,18
0,0,0,0,11,10,19,0,0,0,0,0,0,0,11,10
8,0,11,2,10,6,9,2,3,1,2,3,1,2,10,7
9,1,10,6,4,5,5,7,5,6,4,5,5,6,4,5
