0,0,0,0,0,0,0,0,0,0,0,0,0,0,0,0
0,0,0,0,0,0,0,0,0,0,0,0,0,0,0,0
0,0,0,0,0,0,0,0,0,0,0,0,0,0,0,0
0,0,0,0,0,11,8,0,0,0,0,0,0,0,0,11
3,1,8,0,11,10,19,0,0,0,0,0,0,0,0,18
5,5,12,0,15,5,12,0,0,0,0,11,8,0,0,18
0,0,0,0,0,0,0,0,11,8,0,18,19,0,11,10
0,0,0,0,0,0,0,0,18,19,0,15,12,0,15,5
2,1,2,3,1,2,3,1,10,19,0,0,0,0,0,0
5,5,5,5,5,5,5,5,5,9,1,2,1,3,2,1
