0,0,0,0,0,0,0,0,0,0,0,0,0,0,0,0
2,8,0,0,0,0,0,0,0,11,2,2,8,0,0,0
7,19,0,0,0,0,0,0,0,15,16,16,12,0,0,0
7,19,0,0,11,3,8,0,0,0,0,0,0,0,0,0
7,19,0,0,18,6,9,2,2,2,8,0,0,0,0,0
7,19,0,0,15,16,16,16,16,16,12,0,0,11,3,3
7,19,0,0,0,0,0,0,0,0,0,0,11,10,7,5
7,19,0,0,0,0,0,0,0,11,2,1,10,6,5,5
7,19,0,0,0,11,3,1,3,10,6,7,5,7,5,7
5,9,2,2,2,10,7,7,6,5,7,7,5,5,5,6
