0,0,0,18,19,0,0,0,0,0,0,0,0,0,0,0
0,0,0,18,19,0,0,0,0,0,0,0,0,0,0,0
1,8,0,18,9,8,0,0,0,0,0,0,0,0,0,0
16,12,0,15,16,12,0,0,0,0,0,0,0,0,0,0
0,0,0,0,0,0,0,0,0,0,0,0,0,0,0,0
3,3,3,8,0,0,0,0,0,0,0,0,0,0,0,0
7,7,6,9,8,0,0,11,2,2,2,8,0,0,0,0
7,5,5,5,9,8,0,15,16,16,16,12,0,0,0,0
5,5,7,7,7,19,0,0,0,0,0,0,0,0,0,0
5,6,7,5,5,9,1,3,3,3,3,2,2,2,2,2
