0,0,0,0,0,0,0,0,0,0,0,0,0,0,0,0
0,0,0,0,0,0,0,0,0,0,0,0,0,0,0,0
0,0,0,0,0,0,0,0,0,0,0,0,0,0,0,0
0,0,0,0,0,0,0,0,0,0,0,0,0,0,0,0
0,0,0,0,0,0,0,0,0,0,0,0,0,0,0,0
0,0,0,0,0,0,0,0,0,0,11,1,2,2,2,2
0,0,0,0,0,0,0,0,0,11,10,6,7,5,7,7
2,1,8,0,0,0,0,0,11,10,5,7,5,6,7,5
6,5,19,0,0,0,11,2,10,6,7,5,7,7,5,7
5,7,9,2,2,3,10,7,5,5,7,5,5,5,7,5
