0,0,0,0,0,0,0,0,0,0,0,0,0,0,0,0
0,0,0,0,0,0,0,0,0,0,0,0,0,0,0,0
0,0,0,0,0,0,0,0,0,0,0,0,0,0,0,0
1,2,1,8,0,0,0,11,1,2,8,0,11,3,1,2
7,7,7,9,8,0,0,15,16,16,12,0,18,6,7,7
7,6,5,7,9,8,0,0,0,0,0,0,15,16,16,14
7,7,7,5,7,9,8,0,0,0,0,0,0,0,0,18
7,5,7,6,7,7,9,3,3,1,1,3,3,2,2,10
7,5,7,7,7,5,7,7,7,7,7,7,5,6,7,7
5,6,7,5,7,5,7,7,6,5,7,7,5,5,7,6
