0,0,0,0,0,0,0,0,0,0,0,0,0,0,0,0
0,0,0,0,0,0,0,0,0,0,0,0,0,0,0,0
0,0,0,0,0,0,0,0,0,0,0,0,0,0,0,0
0,0,0,0,0,0,0,0,0,0,0,0,0,0,0,0
0,0,0,0,0,0,0,0,0,0,0,0,0,0,0,0
0,0,0,0,0,0,0,0,0,0,0,0,0,0,0,11
3,3,1,3,8,0,11,3,2,2,3,8,0,11,3,10
5,7,7,6,19,0,0,0,0,0,0,0,0,18,7,7
7,5,7,7,9,2,2,2,2,2,2,2,2,10,7,7
5,6,7,5,7,5,7,7,6,5,7,7,5,5,7,6
